你好 : 안녕하세요
谢谢 : 감사합니다
再见 : 안녕히가세요
爱 : 사랑하다
吃饭 : 밥을먹다
杯子 : 컵
不客气 : 천만에
电脑 : 컴퓨터
电影 : 영화
东西 : 물건
人 : 사람
名字 : 이름
朋友 : 친구
家 : 집
火车站 : 기차역
学校 : 학교
医院 : 병원
菜 : 요리
苹果 : 사과
吃 : 먹다
喝 : 마시다
说 : 말하다
听 : 듣다
开 : 열다
坐 : 앉다
高兴 : 기쁘다
漂亮 : 예쁘다
冷 : 춥다
热 : 덥다
忙 : 바쁘다
这 : 이것
那 : 저것
哪 : 어느
谁 : 누구
怎么 : 어떻게
很 : 매우
看见 : 보이다
找 : 찾다
找到 : 찾아내다
让 : 허락하다
给 : 주다
送 : 보내다
问 : 묻다
告诉 : 알려주다
帮 : 돕다